BBBBBBBBBBBB
BFFFFFFFFFFB
BFFFFFFFFFFB
BFFFFFFFFFFB
BFFFFFFFFFFB
BFFFFFFFFFFB
BFFFFOFFFFFB
BFFFFFFFFFFB
BFFFFFFFFFFB
BFFFFFFFFFFB
BFFFFFFFFFFB
BBBBBBBBBBEB
BFFFFFFFFFFB
BFFFFFFFFFFB
BFFFFFFFFFFB
BFFFFFFFFFFB
BFFFFFFFFFFB
BFFFFOFFFFFB
BFFFFFFFFFFB
BFFFFFFFFFFB
BFFFFFFFFFFB
BFFFFFFFFFFB
BBBBBBBBBBBB