BBBBBBBBBBBBBBBBBBBBBBBBBBBBBBBBBBBBBBBBBBBBBBBBBBBBBBBBBBBBBBBBBBBBBBBBBBBBBBBBBBBBBBBBBBBBBBBBBBBBB
BUUUUUUUUUUUUUUUUUUUUUUUUUUUUUUUUUUUUUUUUUUUUUUUUUUUUUUUUUUUUUUUUUUUUUUUUUUUUUUUUUUUUUUUUUUUUUUUUUUUB
BUUUUUUUUBBBBBBBBBBBBBBBBBBBBBBBBBBBBBBBBBBBBBBBBBBBBBBBBUUUBBBBBBBUUUUUUUUUUUUUUUUUUUUUUUUUUUUUUUUUB
BUUUUUUUBMMMMMMMMMMMMMMMMMMMMMMMMMMMMMMMMMMMMMMMMMMMMMMMMBBUBCCCCCBUUUUUUUUUUUUUUUUUUUUUUUUUUUUUUUUUB
BUUUUBBBBMMMMMMMMMMMMMMMMMMMMMMMMMMMMMMMMMMMMMMMMMMMMMMMMBBBBCCCCCBUUUUUUUUUUUUUUUUUUUUUUUUUUUUUUUUUB
BUUUBBMMMMMMMMMMMMMMMMMMMMMMMMMMMMMMMMMMMMMMMMMMMMMMMMMMMMBBBCCCCCBUUUUUUUUUUUUUUUUUUUUUUUUUUUUUUUUUB
BUUUBMMMMMMMMMMMMMMMMMMMMMMMMMMMMMMMMMMMMMMMMMMMMMMMMMMMMMMMBCCCCCBUUUUUUUUUUUUUUUUUUUUUUUUUUUUUUUUUB
BUUBMMMMMMMMMMMMMMMMMMMMMMMMMMMMMMMMMMMMMMMMMMMMMMMMMMMMMMMMBCCCCCBUUUUUUUUUUUUUUUUUUUUUUUUUUUUUUUUUB
BUUBMMMMMMMMMMMMMMMMMMMMMMMMMMMMMMMMMMMMMMMMMMMMMMMMMMMMMMMMBCCCCCBUUUUUUUUUUUUUUUUUUUUUUUUUUUUUUUUUB
BUUBMMMMMMMMMMMMMMMMMMMMMMMMMMMMMMMMMMMMMMMMMMMMMMMMMMMMMMMMBCCCCCBUUUUUUUUUUUUUUUUUUUUUUUUUUUUUUUUUB
BUBMMMMMMMMMMMMMMMMMMMMMMMMMMMMMMMMMMMMMMMMMMMMMMMMMMMMMMMMMBCCCCCBUUUUUUUUUUUUUUUUUUUUUUUUUUUUUUUUUB
BUBMMMMMMMMMMMMMMMMMMMMMMMMMMMMMMMMMMMMMMMMMMMMMMMMMMBBBBBBBBCCCCCBUUUUUUUUUUUUUUUUUUUUUUUUUUUUUUUUUB
BUBBBBBBBBMMMMMMMMMMMMMMMMMMMMMMMB0000BMMMMMMMMMMMMMBSSSSSSSBCCCCCBUUUUUUUUUUUUUUUUUUUUUUUUUUUUUUUUUB
BUBSSSSSSSBBMMMMMMMMMMMMMMMMMMMMMB0000BMMMMMMMMMBBBBBSSBBBBBBCCCCCBBUUUUUUUUUUUUUUUUUUUUUUUUUUUUUUUUB
BUBSSSSSSSBBMMMMMMMMMMMMMMMMMMMMMB0000BMMMMBBBBBSSSSSSS666666CCCCCCCBUUUUUUUUUUUUUUUUUUUUUUUUUUUUUUUB
BUBSSSSSSSSBBBBBBBBBBBBBBBBBBMMMMB0000BMMMBSSSSSSSSSSSS666666CCCCCCCBUUUUUUUUUUUUUUUUUUUUUUUUUUBUUUUB
BUBBSSSSSSSSSSSSSSSSSSSSSSSSBBBBBB0000BBBBBSSSSSSSSSSSSBBBBBBCCCCCCCBUUUUUUUUUUUUUUUUUUUUUUUBBBUBUUUB
BUBBBSSSSSSSSSSSSSSSSSSSSSSSSSSSSSSSSSSSSSSSSSSSSSSSSSSBBBBBBCCCCCCCCBUUUUUUUUUUUUUUUUUUUUUBCCCCBUUUB
BUBCBBBSSSSSSSSSSSSSSSSSSSSSSSSSSSSSSSSSSSSSSSSSSSSSSSSSSSSBBCCCCCCCCBBBUUUUUUUUUUUUUUUUUUBBCCCCBBUUB
BUBCCCCBBBBBBBBBBBBBBBSSSSSSSSSSSSSSSSSSSSSSSSSSSSSSSSSSSSBCCCCCCCCCCCCCBBBBBBUUUUUUUUUUUBCCCCCCCBUUB
BUBCCCCCCCCCCCCCCCCCCCBBSSSSSSSSSSSSSSSSSSSSSSSSSSSSSSSSSBCCCCCCCCCCCCCCCCCCCCBUUUUUUUBBBBCCCCCCCBUUB
BUBCCCCCCCCCCCCCCCCCCCBBBBSSSSSSSSSSSSSSSSSSSSSSSSSSSSBBBBCCCCCCCCCCCCCCCCCCCCBBBBBBBBCCCCCCCCCCCBUUB
BUBCCCCCCCCCCCCCCCCCCCCCCBBBBSSSSSSSSSSSSSSSSSSSSSSSSBCCCCCCCCCCCCCCCCCCCCCCCCCCCCCCCCCCCCCCCCCCCBUUB
BUBCCCB111BCCCCCCCCCCCCCCCCCBBSSSSSSSSSSSSSSSSSSSSSBBBCCCCCCCCCCCCCCCCCCCCCCCCCCCCCCCCCCCCCCCCCCCBUUB
BUBCCCB111BCCCCCCCCCCCCCCCCCBBBBBBBBBBBBBBBBBBBBBBBCCCCCCCCCCCCCCCCCCCCCCCCCCCCCCCCCCCCCCCCCCCCCCBUUB
BUBCCCB111BCCCCCCCCCCCCCCCCCCCCCCCCCCCCCCCCCCCCCCCCCCCCCCCCCCCCCCCCCCCCCCCCCCCCCCCCCCCCCCCCCCCCCCBUUB
BUBCCCB111BCCCCCCCCCCCCCCCCCCCCCCCCCCCCCCCCCCCCCCCCCCCCCCCCCCCCCCCCCCCCCCCCCCCCCCCCCCCCCCCCCCCCCCBUUB
BUBBBBB111BBBBBBBBCCCCCCCCCCCCCCCCCCCCCCCCCCCCCCCCCCCCCCCCCCCCCCCCCCCCCCBBBBBBBBBBBBBBBBBBBBBBBCCBUUB
BUUBQQQQQQQQQQQQQBBCCCCCCCCCCCCCCCCCCCCCCCCCCCCCCCCCCCCCCCCCCCCCCCCCCCCBUUUUUUUUUUUUUUUUUUUUUUBCCBUUB
BUUBQQQQQQQQQQQQQBBCCCCCCCCCCCCCCCCCCCCCCCCCCCCCCCCCCCCCCCCCCCCCCCCCCCBUUUUUUUUUUUUUUUUUUUUUUUUBCBUUB
BUUBQQQQQQQQQQQQQQQBBCCCCCCCCCCCCCCCCCCCCCCCCCCCCCCCCCCCCCCCCCCCCCCCCCBBBUUUUUUUUUUUUUUUUUUUUUUBCBUUB
BUUBQQQQQQQQQQQQQQQQQBCCCCCCCCCCCCCCCCCCCCCCCCCCCCCCCCCCCCCCCCCCCCCCCBBUUUUUUUUUUUUUUUUUUUUUUUUBCBUUB
BUUBQQQQQQQQQQQQQQQQQBBBCCCCCCCCCCCCCCCCCCCCCCCCCCCCCCCCCCCCCCCCCCCCBBBBBUUUUUUUUUUUUUUUUUUUUUUUBUUUB
BUUBQQQQQQQQQQQQQQQQQQBBBCCCCCCCCCCCCCCCCCCCCCCCCCCCCCCCCCBBBBBBBBBBQQQBUUUUUUUUUUUUUUUUUUUUUUUUUUUUB
BUUUBBBBBBBBBBQQQQQQQQQQBCCCCCCCCCCCCCCCCCCCCCCCCCCCCCCCCBBQQQQQQQQQQQQBUUUUUUUUUUUUUUUUUUUUUUUUUUUUB
BUUBTTTTTTTTTBBQQQQQQQQQBBCCCCCCCCCCCCCCCCCCCCCCCCCCCCCCBBBQQQQQQQQQQQQBUUUUUUUUUUUUUUUUUUUUUUUUUUUUB
BUUBTTTTTTTTTTBQQQQQQQQQQBBCCCCCCCCCCCCCCCCCCCCCCCCCCCCCBQQQQQQQQQQQQQQBUUUUUUUUUUUUUUUUUUUUUUUUUUUUB
BUUBTTTTTTTTTTBBQQQQQQQQQQQBCCCCCCCCCCCCBBBBBBBBBBBBBBBBBQQQQB00BQQQQQQBUUUUUUUUUUUUUUUUUUUUUUUUUUUUB
BUUBTTTTTTTTTTTBBQQQQQQQQQQBBBBBBBBBBBBBQQQQQQQQQQQQQQQQQQQQQB00BQQQQQQBUUUUUUUUUUUUUUUUUUUUUUUUUUUUB
BUUBTTTTTTTTTTTTBQQQQQQQQQQQQQQQQQQQQQQQQQQQQQQQQQQQQQQQQQQQQB00BQQQQQQBUUUUUUUUUUUUUUUUUUUUUUUUUUUUB
BUUBUBBBTTTTTTTTBBBQQQQQQQQQQQQQQQQQQQQQQQQQQQQQQQQQQQQQQQQQQB00BQQQQQQBUUUUUUUUUUUUUUUUUUUUUUUUUUUUB
BUUBUBUBTTTTTTTTTTBBQQQQQQQQQQQQQQQQQQQQQQQQQQQQQQQQQQQBBBBBBB00BQQQQQQBUUUUUUUUUUUUUUUUUUUUUUUUUUUUB
BBBBBBSSBTTTTTTTTTBBQQQQQQQQQQQQQQQQQQQQQQQQQQQQQQQQQQQBBBBBBB00BBBBBBQBUUUUUUUUUUUUUUUUUUUUUUUUUBBBB
BUUUUBDDDBBBBBBTTTTBBQQQQQQQQQQQQQQQQQQQQQQQQQQQQQQQBBBBTTTTTTTTTTTTTBBBUUUUUUUUUUUUUUUUUBBBBUUUUBUUB
BUUUUBDDDD333333TTTTBBBBBQQQQQQQQQQQQQQQQQQQQQQQQQBBBTTTTTTTTTTTTTTTTTTBBBBUUUUUUUUUUUBBBTTTBBBUUBUUB
BUUUUBDDDD333333TTTTTBBBBQQQQQQQQQQQQQQQQQQQQQQQQQBBBTTTTTTTTTTTTTTTTTTTTTBUUUUUUUUUUBTTTTTTBDDBBBUUB
BUUUUBDDDDBBBBBBTTTTTTTTBBBBBBBBBBBBBBBBBBBBBBBBBBBTTTTTTTTTTTTTTTTTTTTTTTBBBBBBBBBBBBTTTTTBDDDBUUUUB
BUUUUBDDDDBBTTTTTTTTTTTTTTTTTTTTTTTTTTTTTTTTTTTTTTTTTTTTTTTTTTTTTTTTTTTTTTTTTTTTTTTTTTTTTTBBDDDBUUUUB
BUUUUBDDDDDBTTTTTTTTTTTTTTTTTTTTTTTTTTTTTTTTTTTTTTTTTTTTTTTTTTTTTTTTTTTTTTTTTTTTTTTTTTTTTBDDDDDBUUUUB
BUUUUBDDDDDBBBTTTTTTTTTTTTTTTTTTTTTTTTTTTTTTTTTTTTTTTTTTBBBBBBBBBBBBBTTTTTTTTTTTTTTTTTTTBDDDDDBBUUUUB
BUUUUBDDDDDDDBTTTTTTTTTTTTTTTTTTTTTTTTTTTTTTTTTTTTTTTTBBBDDDDDDDDDDDBBBBBTTTTTTTTTTTTTBBBDDDDDBBUUUUB
BUUUUBBBDDDDDDBBBTTTTTTTTTTTTTTTTTTTTTTTTTTTTTTTTTTTTBDDDDDDDDDDDDDDDDDDBTTTTTTTTTTTTBDDDDDDDDBUUUUUB
BUUUUUUBDDDDDDDDBTTTTTTTTTTTTTTTTTTTTTTTTTTTTTTTTTTBBBDDDDDDDDDDDDDDDDDDBBBBBBBBBBBBBBDDDDDDDDBUUUUUB
BUUUUUUBDDDDDDDDBBBBTTTTTTTTTTTTTTTTTTTTTTBBBBBBBBBDDDDDDDDDDDDDDDDDDDDDDDDDDDDDDDDDDDDDDDDDDDBUUUUUB
BUUUUUUBBDDDDDDDDDDBBBBBBBBBBBBBBBTTTTTTTTBDDDDDDDDDDDDDDDDDDDDDDDDDDDDDDDDDDDDDDDDDDDDDDDDDDBBUUUUUB
BUUUUUUUBDDDDDDDDDDDDDDDDDDDDDDDDBBBBBBBBBBDDDDDDDDDDDDDDDDDDDDDDDDDDDDDDDDDDDDDDDDDDDDDDDDDBUUUUUUUB
BUUUUUUUBUUUUB11BDDDDDDDDDDDDDDDDDDDDDDDDDDDDDDDDDDDDDDDDDDDDDDDDDDDDDDDDDDDDDDDDDDDDDDDDDDBUUUUUUUUB
BUUUUUUUBBBUUB11BDDDDDDDDDDDDDDDDDDDDDDDDDDDDDDDDDDDDDDDDDDDBBBBBDDDDDDDDDDDDDDDDDDDDDDDDDBBUUUUUUUUB
BUUUUUUUUUBBUB11BDDDDDDDDDDDDDDDDDDDDDDDDDDDDDDDDDDDDDDDBBBBBUUUBBDDDDDDDDDDDDDDDDDDDDDDDBUUUUUUUUUUB
BUUUUUUUUUUBUB11BDDDDDDDDDDDDDDDDDDDDDDDDDDDDDDDDDDDDDDDBUUUUUUUUUBDDDDDDDDDDDDDDDDDDDDDBBUUUUUUUUUUB
BUUUUUUUUUUBBB11BBDDDDDDDDDDDDDDDDDDDDDDDDDDDDDDDDBBBBBBBUUUUUUUUUBBBBDDDDDDDDDDDDDBBBBBBUUUUUUUUUUUB
BUUUUUUUUUUUUUUUUBBBBBBBBBBBBBBBBBBBBBBBBBBBBBBBBBBUUUUUUUUUUUUUUUUUUBBBBBBBBBBBBBBBUUUUUUUUUUUUUUUUB
BUUUUUUUUUUUUUUUUUUUUUUUUUUUUUUUUUUUUUUUUUUUUUUUUUUUUUUUUUUUUUUUUUUUUUUUUUUUUUUUUUUUUUUUUUUUUUUUUUUUB
BUUUUUUUUUUUUUUUUUUUUUUUUUUUUUUUUUUUUUUUUUUUUUUUUUUUUUUUUUUUUUUUUUUUUUUUUUUUUUUUUUUUUUUUUUUUUUUUUUUUB
BUUUUUUUUUUUUUUUUUUUUUUUUUUUUUUUUUUUUUUUUUUUUUUUUUUUUUUUUUUUUUUUUUUUUUUUUUUUUUUUUUUUUUUUUUUUUUUUUUUUB
BUUUUUUUUUUUUUUUUUUUUUUUUUUUUUUUUUUUUUUUUUUUUUUUUUUUUUUUUUUUUUUUUUUUUUUUUUUUUUUUUUUUUUUUUUUUUUUUUUUUB
BUUUUUUUUUUUUUUUUUUUUUUUUUUUUUUUUUUUUUUUUUUUUUUUUUUUUUUUUUUUUUUUUUUUUUUUUUUUUUUUUUUUUUUUUUUUUUUUUUUUB
BUUUUUUUUUUUUUUUUUUUUUUUUUUUUUUUUUUUUUUUUUUUUUUUUUUUUUUUUUUUUUUUUUUUUUUUUUUUUUUUUUUUUUUUUUUUUUUUUUUUB
BUUUUUUUUUUUUUUUUUUUUUUUUUUUUUUUUUUUUUUUUUUUUUUUUUUUUUUUUUUUUUUUUUUUUUUUUUUUUUUUUUUUUUUUUUUUUUUUUUUUB
BUUUUUUUUUUUUUUUUUUUUUUUUUUUUUUUUUUUUUUUUUUUUUUUUUUUUUUUUUUUUUUUUUUUUUUUUUUUUUUUUUUUUUUUUUUUUUUUUUUUB
BUUUUUUUUUUUUUUUUUUUUUUUUUUUUUUUUUUUUUUUUUUUUUUUUUUUUUUUUUUUUUUUUUUUUUUUUUUUUUUUUUUUUUUUUUUUUUUUUUUUB
BUUUUUUUUUUUUUUUUUUUUUUUUUUUUUUUUUUUUUUUUUUUUUUUUUUUUUUUUUUUUUUUUUUUUUUUUUUUUUUUUUUUUUUUUUUUUUUUUUUUB
BUUUUUUUUUUUUUUUUUUUUUUUUUUUUUUUUUUUUUUUUUUUUUUUUUUUUUUUUUUUUUUUUUUUUUUUUUUUUUUUUUUUUUUUUUUUUUUUUUUUB
BUUUUUUUUUUUUUUUUUUUUUUUUUUUUUUUUUUUUUUUUUUUUUUUUUUUUUUUUUUUUUUUUUUUUUUUUUUUUUUUUUUUUUUUUUUUUUUUUUUUB
BUUUUUUUUUUUUUUUUUUUUUUUUUUUUUUUUUUUUUUUUUUUUUUUUUUUUUUUUUUUUUUUUUUUUUUUUUUUUUUUUUUUUUUUUUUUUUUUUUUUB
BUUUUUUUUUUUUUUUUUUUUUUUUUUUUUUUUUUUUUUUUUUUUUUUUUUUUUUUUUUUUUUUUUUUUUUUUUUUUUUUUUUUUUUUUUUUUUUUUUUUB
BUUUUUUUUUUUUUUUUUUUUUUUUUUUUUUUUUUUUUUUUUUUUUUUUUUUUUUUUUUUUUUUUUUUUUUUUUUUUUUUUUUUUUUUUUUUUUUUUUUUB
BUUUUUUUUUUUUUUUUUUUUUUUUUUUUUUUUUUUUUUUUUUUUUUUUUUUUUUUUUUUUUUUUUUUUUUUUUUUUUUUUUUUUUUUUUUUUUUUUUUUB
BUUUUUUUUUUUUUUUUUUUUUUUUUUUUUUUUUUUUUUUUUUUUUUUUUUUUUUUUUUUUUUUUUUUUUUUUUUUUUUUUUUUUUUUUUUUUUUUUUUUB
BUUUUUUUUUUUUUUUUUUUUUUUUUUUUUUUUUUUUUUUUUUUUUUUUUUUUUUUUUUUUUUUUUUUUUUUUUUUUUUUUUUUUUUUUUUUUUUUUUUUB
BUUUUUUUUUUUUUUUUUUUUUUUUUUUUUUUUUUUUUUUUUUUUUUUUUUUUUUUUUUUUUUUUUUUUUUUUUUUUUUUUUUUUUUUUUUUUUUUUUUUB
BUUUUUUUUUUUUUUUUUUUUUUUUUUUUUUUUUUUUUUUUUUUUUUUUUUUUUUUUUUUUUUUUUUUUUUUUUUUUUUUUUUUUUUUUUUUUUUUUUUUB
BUUUUUUUUUUUUUUUUUUUUUUUUUUUUUUUUUUUUUUUUUUUUUUUUUUUUUUUUUUUUUUUUUUUUUUUUUUUUUUUUUUUUUUUUUUUUUUUUUUUB
BUUUUUUUUUUUUUUUUUUUUUUUUUUUUUUUUUUUUUUUUUUUUUUUUUUUUUUUUUUUUUUUUUUUUUUUUUUUUUUUUUUUUUUUUUUUUUUUUUUUB
BUUUUUUUUUUUUUUUUUUUUUUUUUUUUUUUUUUUUUUUUUUUUUUUUUUUUUUUUUUUUUUUUUUUUUUUUUUUUUUUUUUUUUUUUUUUUUUUUUUUB
BUUUUUUUUUUUUUUUUUUUUUUUUUUUUUUUUUUUUUUUUUUUUUUUUUUUUUUUUUUUUUUUUUUUUUUUUUUUUUUUUUUUUUUUUUUUUUUUUUUUB
BUUUUUUUUUUUUUUUUUUUUUUUUUUUUUUUUUUUUUUUUUUUUUUUUUUUUUUUUUUUUUUUUUUUUUUUUUUUUUUUUUUUUUUUUUUUUUUUUUUUB
BUUUUUUUUUUUUUUUUUUUUUUUUUUUUUUUUUUUUUUUUUUUUUUUUUUUUUUUUUUUUUUUUUUUUUUUUUUUUUUUUUUUUUUUUUUUUUUUUUUUB
BUUUUUUUUUUUUUUUUUUUUUUUUUUUUUUUUUUUUUUUUUUUUUUUUUUUUUUUUUUUUUUUUUUUUUUUUUUUUUUUUUUUUUUUUUUUUUUUUUUUB
BUUUUUUUUUUUUUUUUUUUUUUUUUUUUUUUUUUUUUUUUUUUUUUUUUUUUUUUUUUUUUUUUUUUUUUUUUUUUUUUUUUUUUUUUUUUUUUUUUUUB
BUUUUUUUUUUUUUUUUUUUUUUUUUUUUUUUUUUUUUUUUUUUUUUUUUUUUUUUUUUUUUUUUUUUUUUUUUUUUUUUUUUUUUUUUUUUUUUUUUUUB
BUUUUUUUUUUUUUUUUUUUUUUUUUUUUUUUUUUUUUUUUUUUUUUUUUUUUUUUUUUUUUUUUUUUUUUUUUUUUUUUUUUUUUUUUUUUUUUUUUUUB
BUUUUUUUUUUUUUUUUUUUUUUUUUUUUUUUUUUUUUUUUUUUUUUUUUUUUUUUUUUUUUUUUUUUUUUUUUUUUUUUUUUUUUUUUUUUUUUUUUUUB
BUUUUUUUUUUUUUUUUUUUUUUUUUUUUUUUUUUUUUUUUUUUUUUUUUUUUUUUUUUUUUUUUUUUUUUUUUUUUUUUUUUUUUUUUUUUUUUUUUUUB
BUUUUUUUUUUUUUUUUUUUUUUUUUUUUUUUUUUUUUUUUUUUUUUUUUUUUUUUUUUUUUUUUUUUUUUUUUUUUUUUUUUUUUUUUUUUUUUUUUUUB
BUUUUUUUUUUUUUUUUUUUUUUUUUUUUUUUUUUUUUUUUUUUUUUUUUUUUUUUUUUUUUUUUUUUUUUUUUUUUUUUUUUUUUUUUUUUUUUUUUUUB
BUUUUUUUUUUUUUUUUUUUUUUUUUUUUUUUUUUUUUUUUUUUUUUUUUUUUUUUUUUUUUUUUUUUUUUUUUUUUUUUUUUUUUUUUUUUUUUUUUUUB
BUUUUUUUUUUUUUUUUUUUUUUUUUUUUUUUUUUUUUUUUUUUUUUUUUUUUUUUUUUUUUUUUUUUUUUUUUUUUUUUUUUUUUUUUUUUUUUUUUUUB
BUUUUUUUUUUUUUUUUUUUUUUUUUUUUUUUUUUUUUUUUUUUUUUUUUUUUUUUUUUUUUUUUUUUUUUUUUUUUUUUUUUUUUUUUUUUUUUUUUUUB
BUUUUUUUUUUUUUUUUUUUUUUUUUUUUUUUUUUUUUUUUUUUUUUUUUUUUUUUUUUUUUUUUUUUUUUUUUUUUUUUUUUUUUUUUUUUUUUUUUUUB
BBBBBBBBBBBBBBBBBBBBBBBBBBBBBBBBBBBBBBBBBBBBBBBBBBBBBBBBBBBBBBBBBBBBBBBBBBBBBBBBBBBBBBBBBBBBBBBBBBBBB