BBBBBBBBBBBB
BFFFFFFFFFFB
BFFFFFBBBBFB
BFFFFFBBBBFB
BFFFFFFFFFFB
BFFFFFFFFFFB
BFBBFFFFFFFB
BFBBFFFFFFFB
BFBBFFFFFFFB
BFBBFFFFFFFB
BFFFFFFFFFFB
BBBBBBBBBBBB